111111111111111111111111111111
1P0000000100000000000000000001
11111111C100000C01110C01110C01
100000000100110000000000000001
1C1111111100110000000000000001
100000000100110C01110C01110C01
101000110100110000000000000001
10C000110100110000000000000001
1011000C0100110C01110C01110C01
101100010100110000000000000001
100000000000110000000000000001
100000000100000000000000000001
11111111C100000C01110C01110C01
100000000100110000000000000001
1C1111111100110000000000000001
100000000100110C01110C01110C01
101000110100110000000000000001
10C000110100110000000000000001
1011000C0100110C01110C01110C01
101100010100110000000000000001
1000000000001100000000000000E1
111111111111111111111111111111